9 9 9 9    9 9 9 9    9 9 9 9    9 9 9 9    9 9 9 9    9 9 9 9    9 9 9 9    9 9 9 9    9 9 9 9    9 9 9 9    9 9 9 9
9 9 9 9    9 9 9 9    9 9 9 9    9 9 9 9    9 9 9 9    9 9 9 9    9 9 9 9    9 9 9 9    9 9 9 9    9 9 9 9    9 9 9 9
9 9 9 9    9 9 9 9    9 9 9 9    9 9 9 9    9 9 9 9    9 9 9 9    9 9 9 9    9 9 9 9    9 9 9 9    9 9 9 9    9 9 9 9
9 9 9 9    9 9 9 9    9 9 9 9    9 9 9 9    9 9 9 9    9 9 9 9    9 9 9 9    9 9 9 9    9 9 9 9    9 9 9 9    9 9 9 9

9 9 9 9    9 9 9 9    9 9 9 9    9 9 9 9    9 9 9 9    9 9 9 9    9 9 9 9    9 9 9 9    9 9 9 9    9 9 9 9    9 9 9 9
9 9 9 9    9 9 9 9    9 9 9 9    9 9 9 9    9 9 9 9    9 9 9 9    9 9 9 9    9 9 9 9    9 9 9 9    9 9 9 9    9 9 9 9
9 9 9 9    9 9 9 9    9 9 9 9    9 9 9 9    9 9 9 9    9 9 9 9    9 9 9 9    9 9 9 9    9 9 9 9    9 9 9 9    9 9 9 9
9 9 9 9    9 9 9 9    9 9 9 9    9 9 9 9    9 9 9 9    9 9 9 9    9 9 9 9    9 9 9 9    9 9 9 9    9 9 9 9    9 9 9 9

9 9 9 9    9 9 9 9    9 9 9 9    9 9 9 9    9 9 9 9    9 9 9 9    9 9 9 9    9 9 9 9    9 9 9 9    9 9 9 9    9 9 9 9
9 9 9 9    9 9 9 9    9 9 9 9    9 9 9 9    9 9 9 9    9 9 9 9    9 9 9 9    9 9 9 9    9 9 9 9    9 9 9 9    9 9 9 9
9 9 9 9    9 9 9 9    9 9 9 9    9 9 5 6    5 6 9 9    9 9 9 9    9 9 9 9    9 9 9 9    9 9 9 9    9 9 9 9    9 9 9 9
9 9 9 9    9 9 9 9    9 9 9 9    9 9 6 5    5 6 9 9    9 9 9 9    9 9 9 9    9 9 9 9    9 9 9 9    9 9 9 9    9 9 9 9

9 9 9 9    9 9 9 9    9 9 9 9    9 9 5 5    5 4 9 9    9 9 9 9    9 9 9 9    9 9 9 9    9 9 9 9    9 9 9 9    9 9 9 9
9 9 9 9    9 9 9 9    9 9 9 9    9 9 6 4    6 4 9 9    9 9 9 9    9 9 9 9    9 9 9 9    9 9 9 9    9 9 9 9    9 9 9 9
9 9 9 9    9 9 9 9    9 9 5 5    4 4 5 5    6 4 1 1    1 1 1 1    1 1 5 6    6 5 4 4    4 5 9 9    9 9 9 9    9 9 9 9
9 9 9 9    9 9 9 9    9 9 4 6    5 4 5 6    5 5 1 1    5 5 5 6    1 1 6 5    4 5 6 5    6 4 9 9    9 9 9 9    9 9 9 9

9 9 9 9    9 9 9 9    9 9 5 5    6 5 6 5    6 6 5 4    6 4 5 6    4 4 6 4    K - - -    4 6 9 9    9 9 9 9    9 9 9 9
9 9 9 9    9 9 9 9    9 9 4 5    6 5 5 4    6 5 6 4    4 6 4 5    5 4 6 5    - - - -    6 5 9 9    9 9 9 9    9 9 9 9
9 9 9 9    9 9 9 9    9 9 6 6    6 4 6 6    6 5 6 5    4 4 4 5    4 6 6 5    - - - -    5 4 9 9    9 9 9 9    9 9 9 9
9 9 9 9    9 9 9 9    9 9 4 5    4 6 4 4    5 5 5 6    4 5 5 4    6 6 5 4    - - - -    6 4 9 9    9 9 9 9    9 9 9 9

9 9 9 9    9 9 9 9    9 9 4 6    4 4 6 5    5 4 1 1    4 6 5 6    1 1 4 4    5 5 4 4    6 4 9 9    9 9 9 9    9 9 9 9
9 9 9 9    9 9 9 9    9 9 1 1    1 1 1 1    1 1 1 1    4 4 4 5    1 1 1 1    1 1 1 1    1 1 9 9    9 9 9 9    9 9 9 9
9 9 9 9    9 9 9 9    9 9 6 5    4 6 6 5    5 5 6 4    6 5 4 5    4 6 4 5    5 6 4 4    4 6 9 9    9 9 9 9    9 9 9 9
9 9 9 9    9 9 9 9    9 9 4 5    6 6 6 6    4 6 6 4    5 5 6 6    5 4 4 6    6 5 4 5    5 6 9 9    9 9 9 9    9 9 9 9

9 9 9 9    9 9 9 9    9 9 6 4    4 6 6 4    4 5 6 4    6 5 6 5    4 4 6 4    5 5 4 6    4 4 9 9    9 9 9 9    9 9 9 9
9 9 9 9    9 9 9 9    9 9 6 5    5 6 5 5    4 4 1 1    5 4 5 6    1 1 5 4    4 6 5 4    6 4 9 9    9 9 9 9    9 9 9 9
9 9 9 9    9 9 9 9    9 9 1 1    1 1 1 1    1 1 1 1    5 5 4 4    1 1 1 1    1 1 1 1    1 1 9 9    9 9 9 9    9 9 9 9
9 9 9 9    9 9 9 9    9 9 0 0    0 0 0 0    5 6 1 1    4 6 4 5    1 1 6 6    5 6 6 5    0 0 9 9    9 9 9 9    9 9 9 9

9 9 9 9    9 9 9 9    9 9 0 0    0 0 0 0    6 5 6 5    4 5 6 4    4 5 6 5    5 6 4 6    0 0 9 9    9 9 9 9    9 9 9 9
9 9 9 9    9 9 9 9    9 9 0 0    0 0 0 0    6 5 6 5    5 6 4 4    5 4 4 6    6 4 5 4    0 0 9 9    9 9 9 9    9 9 9 9
9 9 9 9    9 9 9 9    9 9 0 0    0 0 0 0    4 5 6 4    6 6 4 4    5 4 5 4    5 6 5 6    0 0 9 9    9 9 9 9    9 9 9 9
9 9 9 9    9 9 9 9    9 9 1 1    1 1 1 1    1 1 1 1    6 4 4 5    1 1 1 1    1 1 1 1    1 1 9 9    9 9 9 9    9 9 9 9

9 9 9 9    9 9 9 9    9 9 6 4    4 5 6 4    4 4 4 5    5 6 4 6    5 4 5 4    6 6 4 4    5 5 9 9    9 9 9 9    9 9 9 9
9 9 9 9    9 9 9 9    9 9 4 5    6 6 4 4    5 4 5 4    4 4 6 4    6 4 6 6    4 5 6 4    6 4 9 9    9 9 9 9    9 9 9 9
9 9 9 9    9 9 9 9    9 9 4 6    5 4 5 4    6 4 6 5    5 4 6 4    6 6 4 4    4 4 4 5    6 4 9 9    9 9 9 9    9 9 9 9
9 9 9 9    9 9 9 9    9 9 6 5    6 6 4 5    4 5 4 6    6 4 5 4    5 4 5 5    4 5 6 4    5 6 9 9    9 9 9 9    9 9 9 9

9 9 9 9    9 9 9 9    9 9 9 9    9 9 9 9    9 9 9 9    9 9 9 9    9 9 9 9    9 9 9 9    9 9 9 9    9 9 9 9    9 9 9 9
9 9 9 9    9 9 9 9    9 9 9 9    9 9 9 9    9 9 9 9    9 9 9 9    9 9 9 9    9 9 9 9    9 9 9 9    9 9 9 9    9 9 9 9
9 9 9 9    9 9 9 9    9 9 9 9    9 9 9 9    9 9 9 9    9 9 9 9    9 9 9 9    9 9 9 9    9 9 9 9    9 9 9 9    9 9 9 9
9 9 9 9    9 9 9 9    9 9 9 9    9 9 9 9    9 9 9 9    9 9 9 9    9 9 9 9    9 9 9 9    9 9 9 9    9 9 9 9    9 9 9 9

9 9 9 9    9 9 9 9    9 9 9 9    9 9 9 9    9 9 9 9    9 9 9 9    9 9 9 9    9 9 9 9    9 9 9 9    9 9 9 9    9 9 9 9
9 9 9 9    9 9 9 9    9 9 9 9    9 9 9 9    9 9 9 9    9 9 9 9    9 9 9 9    9 9 9 9    9 9 9 9    9 9 9 9    9 9 9 9
9 9 9 9    9 9 9 9    9 9 9 9    9 9 9 9    9 9 9 9    9 9 9 9    9 9 9 9    9 9 9 9    9 9 9 9    9 9 9 9    9 9 9 9
9 9 9 9    9 9 9 9    9 9 9 9    9 9 9 9    9 9 9 9    9 9 9 9    9 9 9 9    9 9 9 9    9 9 9 9    9 9 9 9    9 9 9 9

Level_1.txt
Level_2.txt
Level_3.txt
Level_4.txt

circle 181 188 0   255 255 0   up 200 440 1 0
circle 181 188 0   255 255 0   up 600 540 1 0

circle 179 9   179 255 0   255 up 200 540 2 0
circle 179 9   179 255 0   255 up 600 440 2 0

circle 0   195 195 0   255 255 up 520 440 3 0

circle 0   142 28  0   255 0   up 280 540 4 0

horizontal 255 255 0 up 400 420 1
horizontal 255 0 255 up 400 400 2
vertical 0 255 255 up 360 320 3
vertical 0 255 0 up 500 320 4

barrier 360 200 320 80 1
barrier 680 280 80 440 1
barrier 200 200 80 80 1
barrier 160 360 40 360 1
barrier 360 280 40 40 1
barrier 480 280 40 40 1
barrier 400 280 80 20 1
barrier 360 400 40 40 1
barrier 200 420 160 20 1
barrier 360 500 40 60 1
barrier 200 520 160 20 1
barrier 200 620 200 20 1
barrier 480 400 40 40 1
barrier 520 420 160 20 1
barrier 480 500 40 60 1
barrier 520 520 160 20 1
barrier 480 620 200 20 1
barrier 200 720 200 40 1
barrier 480 720 200 40 1
barrier 280 160 80 40 1
barrier 160 280 40 80 1
barrier 360 560 40 60 1
barrier 360 440 40 60 1
barrier 480 440 40 60 1
barrier 480 560 40 60 0

arrow 400 640 down
arrow 280 200 up
arrow 200 280 left

door 480 560 40 60 0 0
door 360 560 40 60 1 8
door 360 440 40 60 1 4
door 480 440 40 60 1 0