9 9 9 9    9 9 9 9    9 9 9 9    9 9 9 9    9 9 9 9    9 9 9 9    9 9 9 9    9 9 9 9    9 9 9 9    9 9 9 9    9 9 9 9
9 9 9 9    9 9 9 9    9 9 9 9    9 9 9 9    9 9 9 9    9 9 9 9    9 9 9 9    9 9 9 9    9 9 9 9    9 9 9 9    9 9 9 9

9 9 9 9    9 9 9 9    9 9 9 9    9 9 9 9    9 9 9 9    9 9 9 9    9 9 9 9    9 9 9 9    9 9 9 9    9 9 9 9    9 9 9 9
9 9 9 9    9 9 9 9    9 9 9 9    9 9 9 9    9 9 9 9    9 9 9 9    9 9 9 9    9 9 9 9    9 9 9 9    9 9 9 9    9 9 9 9
9 9 9 9    9 9 9 9    9 9 9 9    9 9 9 9    9 9 9 9    9 9 9 9    9 9 9 9    9 9 9 9    9 9 9 9    9 9 9 9    9 9 9 9
9 9 9 9    9 9 9 9    9 9 9 9    9 9 9 9    9 9 9 9    9 9 9 9    9 9 9 9    9 9 9 9    9 9 9 9    9 9 9 9    9 9 9 9

9 9 9 9    9 9 9 9    9 9 9 9    9 9 9 9    9 9 9 9    9 9 9 9    9 9 9 9    9 9 9 9    9 9 9 9    9 9 9 9    9 9 9 9
9 9 9 9    9 9 9 9    9 9 9 9    9 9 9 9    9 9 9 9    9 9 9 9    9 9 9 9    9 9 9 9    9 9 9 9    9 9 9 9    9 9 9 9
9 9 9 9    9 9 9 9    9 9 9 9    9 9 9 9    9 9 9 9    9 9 9 9    9 9 9 9    9 9 9 9    9 9 9 9    9 9 9 9    9 9 9 9
9 9 9 9    9 9 9 9    9 9 9 9    9 9 9 9    9 9 9 9    9 9 9 9    9 9 9 9    9 9 9 9    9 9 9 9    9 9 9 9    9 9 9 9
 
9 9 9 9    9 9 9 9    9 9 0 0    0 0 0 0    0 0 0 0    0 0 2 2    2 2 0 0    0 0 0 0    7 0 9 9    9 9 9 9    9 9 9 9
9 9 9 9    9 9 9 9    9 9 0 0    0 0 0 0    0 0 0 0    0 0 2 2    2 2 0 0    0 0 7 7    7 7 9 9    9 9 9 9    9 9 9 9
9 9 9 9    9 9 9 9    9 9 0 0    0 0 0 0    0 0 0 0    0 0 2 2    2 2 0 0    0 0 7 7    7 7 9 9    9 9 9 9    9 9 9 9
9 9 9 9    9 9 9 9    9 9 0 0    0 0 0 0    0 0 0 0    0 0 2 2    2 2 0 0    0 0 0 0    7 0 9 9    9 9 9 9    9 9 9 9
 
9 9 9 9    9 9 9 9    9 9 0 7    0 0 0 0    0 0 0 0    0 0 2 2    2 2 0 0    0 0 0 0    0 0 9 9    9 9 9 9    9 9 9 9
9 9 9 9    9 9 9 9    9 9 7 7    7 7 0 0    0 0 0 0    0 0 2 2    2 2 0 0    0 0 0 0    0 0 9 9    9 9 9 9    9 9 9 9
9 9 9 9    9 9 9 9    9 9 7 7    7 7 0 0    0 0 0 0    0 0 2 2    2 2 0 0    0 0 0 0    0 0 9 9    9 9 9 9    9 9 9 9
9 9 9 9    9 9 9 9    9 9 0 7    0 0 0 0    0 0 0 0    0 0 2 2    2 2 0 0    0 0 0 0    0 0 9 9    9 9 9 9    9 9 9 9
 
9 9 9 9    9 9 9 9    9 9 0 0    0 0 0 0    0 0 0 0    0 0 2 2    2 2 0 0    0 0 0 0    0 0 9 9    9 9 9 9    9 9 9 9
9 9 9 9    9 9 9 9    9 9 0 0    0 0 0 0    0 0 0 0    0 0 2 2    2 2 0 0    0 0 0 0    0 0 9 9    9 9 9 9    9 9 9 9
9 9 9 9    9 9 9 9    9 9 0 0    0 0 0 0    0 0 0 0    0 0 2 2    2 2 0 0    0 0 0 0    0 0 9 9    9 9 9 9    9 9 9 9
9 9 9 9    9 9 9 9    9 9 1 1    1 1 0 0    0 0 1 1    1 1 2 2    2 2 0 0    0 0 0 0    0 0 9 9    9 9 9 9    9 9 9 9
 
9 9 9 9    9 9 9 9    9 9 0 0    0 0 0 0    0 0 0 0    0 0 2 2    2 2 0 0    0 0 0 0    0 0 9 9    9 9 9 9    9 9 9 9
9 9 9 9    9 9 9 9    9 9 0 0    0 0 0 0    0 0 0 0    0 0 2 2    2 2 0 0    0 0 0 0    0 0 9 9    9 9 9 9    9 9 9 9
9 9 9 9    9 9 9 9    9 9 0 0    0 0 0 0    0 0 0 0    0 0 2 2    2 2 0 0    0 0 0 0    0 0 9 9    9 9 9 9    9 9 9 9
9 9 9 9    9 9 9 9    9 9 0 0    0 0 0 0    0 0 0 0    0 0 2 2    2 2 0 0    0 0 0 0    0 0 9 9    9 9 9 9    9 9 9 9
 
9 9 9 9    9 9 9 9    9 9 0 7    0 0 0 0    0 0 0 0    0 0 2 2    2 2 0 0    0 0 0 0    0 0 9 9    9 9 9 9    9 9 9 9
9 9 9 9    9 9 9 9    9 9 7 7    7 7 0 0    0 0 0 0    0 0 2 2    2 2 0 0    0 0 0 0    0 0 9 9    9 9 9 9    9 9 9 9
9 9 9 9    9 9 9 9    9 9 7 7    7 7 0 0    0 0 0 0    0 0 2 2    2 2 0 0    0 0 0 0    0 0 9 9    9 9 9 9    9 9 9 9
9 9 9 9    9 9 9 9    9 9 0 7    0 0 0 0    0 0 0 0    0 0 2 2    2 2 0 0    0 0 0 0    0 0 9 9    9 9 9 9    9 9 9 9
 
9 9 9 9    9 9 9 9    9 9 0 0    0 0 0 0    0 0 0 0    0 0 2 2    2 2 0 0    0 0 0 0    0 0 9 9    9 9 9 9    9 9 9 9
9 9 9 9    9 9 9 9    9 9 0 0    0 0 0 0    0 0 0 0    0 0 2 2    2 2 0 0    0 0 0 0    0 0 9 9    9 9 9 9    9 9 9 9
9 9 9 9    9 9 9 9    9 9 0 0    0 0 0 0    0 0 0 0    0 0 2 2    2 2 0 0    0 0 0 0    0 0 9 9    9 9 9 9    9 9 9 9
9 9 9 9    9 9 9 9    9 9 0 0    0 0 0 0    0 0 0 0    0 0 2 2    2 2 0 0    0 0 0 0    0 0 9 9    9 9 9 9    9 9 9 9
 
9 9 9 9    9 9 9 9    9 9 9 9    9 9 9 9    9 9 9 9    9 9 9 9    9 9 9 9    9 9 9 9    9 9 9 9    9 9 9 9    9 9 9 9
9 9 9 9    9 9 9 9    9 9 9 9    9 9 9 9    9 9 9 9    9 9 9 9    9 9 9 9    9 9 9 9    9 9 9 9    9 9 9 9    9 9 9 9
9 9 9 9    9 9 9 9    9 9 9 9    9 9 9 9    9 9 9 9    9 9 9 9    9 9 9 9    9 9 9 9    9 9 9 9    9 9 9 9    9 9 9 9
9 9 9 9    9 9 9 9    9 9 9 9    9 9 9 9    9 9 9 9    9 9 9 9    9 9 9 9    9 9 9 9    9 9 9 9    9 9 9 9    9 9 9 9

9 9 9 9    9 9 9 9    9 9 9 9    9 9 9 9    9 9 9 9    9 9 9 9    9 9 9 9    9 9 9 9    9 9 9 9    9 9 9 9    9 9 9 9
9 9 9 9    9 9 9 9    9 9 9 9    9 9 9 9    9 9 9 9    9 9 9 9    9 9 9 9    9 9 9 9    9 9 9 9    9 9 9 9    9 9 9 9
9 9 9 9    9 9 9 9    9 9 9 9    9 9 9 9    9 9 9 9    9 9 9 9    9 9 9 9    9 9 9 9    9 9 9 9    9 9 9 9    9 9 9 9
9 9 9 9    9 9 9 9    9 9 9 9    9 9 9 9    9 9 9 9    9 9 9 9    9 9 9 9    9 9 9 9    9 9 9 9    9 9 9 9    9 9 9 9

9 9 9 9    9 9 9 9    9 9 9 9    9 9 9 9    9 9 9 9    9 9 9 9    9 9 9 9    9 9 9 9    9 9 9 9    9 9 9 9    9 9 9 9
9 9 9 9    9 9 9 9    9 9 9 9    9 9 9 9    9 9 9 9    9 9 9 9    9 9 9 9    9 9 9 9    9 9 9 9    9 9 9 9    9 9 9 9

Level_1.txt
Level_2.txt
Level_3.txt
Level_4.txt

square 223 119 0   255 137 0   up 600 360 0 0
circle 71 71 71 97  97  97  up 280 520 1 0

horizontal 97  97  97 up 280 420 1

barrier 200 160 480 40 1
barrier 160 200 40 480 1
barrier 680 280 40 400 1
barrier 200 680 480 40 1
barrier 200 420 80 20 1
barrier 360 420 80 20 1
barrier 440 200 80 480 1

arrow 600 200 right
arrow 200 280 left
arrow 200 520 left

springboard 360 280 down right
springboard 520 520 down left